1111111111111
10000CC0000C1
1C00P00011101
110011E000001
1111111111111